1 3 1 1 1 5 3 1 1 1 5 3 5 1 1
1 3 1 1 3 5 5 1 3 3 5 1 5 5 1
3 1 1 5 3 3 5 3 8 1 3 5 3 1 5
1 1 1 12 5 5 3 3 1 3 1 5 1 5 3
3 1 3 1 1 5 1 1 5 1 1 1 1 3 1
1 3 3 5 5 1 1 1 5 5 3 5 1 3 1
5 1 3 3 5 1 5 5 5 1 1 5 1 3 1
5 1 5 3 5 3 5 5 1 5 5 3 1 1 1
1 12 16 8 1 5 1 5 3 1 3 3 3 1 5